6 12
############
#XX@.....#.#
##.#.#...#.#
#S....@...##
##.#.#..#..#
############
