7 9
#########
####X####
####@####
#X.@S.@X#
####@####
####X####
#########